#########
#   .   #
# $ $ $ #
# . @ . #
# $ $ $ #
#   .   #
#########