###########
#    #    #
# .$ # $. #
#  @$@$   #
# .$ # $. #
#    #    #
###########