########
#      #
# .$@$ #
# .$ $.#
#    . #
########