#######
#     #
# @$  #
# .$ .#
#######