#######
#     #
# $   #
#  .  #
# @   #
#######