#########
#       #
# @$ $@ #
# .$..$.#
#       #
#########