##########
#   .    #
# $$@$   #
#   .    #
##########