##########
#   .    #
# #$#$#  #
#  $@$   #
#  #. #  #
##########