#########
#   .   #
# $ $ $ #
#   @   #
#   .   #
#########